//MAP CONVERTED BY dmm2tgm.py THIS HEADER COMMENT PREVENTS RECONVERSION, DO NOT REMOVE
"a" = (
/turf/template_noop,
/area/space)
"b" = (
/obj/machinery/light,
/turf/simulated/floor/tiled/dark,
/area/space)
"e" = (
/obj/structure/table/steel_reinforced,
/obj/effect/floor_decal/techfloor{
	dir = 10;
	icon_state = "techfloor_edges"
	},
/obj/item/gun/projectile/automatic/semistrip,
/obj/item/gun/projectile/automatic/semistrip,
/turf/simulated/floor/tiled/techfloor,
/area/space)
"f" = (
/obj/structure/table/steel_reinforced,
/obj/effect/floor_decal/techfloor{
	dir = 4;
	icon_state = "techfloor_edges"
	},
/obj/item/ammo_magazine/smg_top,
/obj/item/ammo_magazine/smg_top,
/obj/item/ammo_magazine/smg_top,
/obj/item/ammo_magazine/smg_top,
/obj/item/ammo_magazine/smg_top,
/obj/item/ammo_magazine/smg_top,
/obj/item/ammo_magazine/smg_top,
/obj/item/ammo_magazine/smg_top,
/turf/simulated/floor/tiled/techfloor,
/area/space)
"g" = (
/obj/machinery/light,
/turf/simulated/floor/tiled/techfloor,
/area/space)
"h" = (
/obj/structure/table/steel_reinforced,
/obj/effect/floor_decal/techfloor{
	dir = 1;
	icon_state = "techfloor_edges"
	},
/obj/machinery/light{
	dir = 1
	},
/obj/item/grenade/frag{
	pixel_x = -6
	},
/obj/item/grenade/frag{
	pixel_x = -6
	},
/obj/item/grenade/frag{
	pixel_x = -6
	},
/obj/item/grenade/flashbang{
	pixel_x = 6
	},
/obj/item/grenade/flashbang{
	pixel_x = 6
	},
/obj/item/grenade/flashbang{
	pixel_x = 6
	},
/turf/simulated/floor/tiled/techfloor,
/area/space)
"i" = (
/obj/machinery/door/airlock/highsecurity,
/turf/simulated/floor/tiled/dark,
/area/space)
"j" = (
/turf/simulated/floor/tiled/dark/monotile,
/area/space)
"k" = (
/obj/structure/table/steel_reinforced,
/obj/item/clothing/head/helmet/ballistic,
/obj/item/clothing/head/helmet/ballistic,
/obj/item/clothing/head/helmet/ballistic,
/obj/item/clothing/head/helmet/ballistic,
/obj/item/clothing/head/helmet/ballistic,
/obj/item/clothing/head/helmet/ballistic,
/turf/simulated/floor/tiled/techfloor,
/area/space)
"l" = (
/obj/structure/table/steel_reinforced,
/obj/item/modular_computer/laptop,
/turf/simulated/floor/tiled/techfloor,
/area/space)
"m" = (
/obj/structure/table/steel_reinforced,
/obj/effect/floor_decal/techfloor{
	dir = 5;
	icon_state = "techfloor_edges"
	},
/obj/item/ammo_magazine/machine_pistol,
/obj/item/ammo_magazine/machine_pistol,
/obj/item/ammo_magazine/machine_pistol,
/obj/item/ammo_magazine/machine_pistol,
/obj/item/ammo_magazine/machine_pistol,
/obj/item/ammo_magazine/machine_pistol,
/obj/item/ammo_magazine/machine_pistol,
/obj/item/ammo_magazine/machine_pistol,
/turf/simulated/floor/tiled/techfloor,
/area/space)
"n" = (
/obj/effect/floor_decal/techfloor/corner,
/obj/effect/floor_decal/techfloor/corner{
	dir = 8
	},
/turf/simulated/floor/tiled/techfloor,
/area/space)
"p" = (
/obj/machinery/computer/prisoner{
	dir = 1
	},
/turf/simulated/floor/tiled/dark,
/area/space)
"q" = (
/turf/simulated/floor/tiled/dark,
/area/space)
"r" = (
/turf/simulated/wall/r_wall,
/area/space)
"s" = (
/obj/machinery/door/airlock/glass/security{
	name = "Cell 3"
	},
/turf/simulated/floor/tiled/dark/monotile,
/area/space)
"t" = (
/obj/structure/table/steel_reinforced,
/obj/item/clothing/gloves/terran,
/obj/item/clothing/gloves/terran,
/obj/item/clothing/gloves/terran,
/obj/item/clothing/gloves/terran,
/obj/item/clothing/gloves/terran,
/obj/item/clothing/gloves/terran,
/turf/simulated/floor/tiled/techfloor,
/area/space)
"u" = (
/obj/effect/floor_decal/spline/plain/red{
	dir = 8
	},
/obj/machinery/light/small{
	dir = 8
	},
/turf/simulated/floor/tiled/dark/monotile,
/area/space)
"v" = (
/obj/structure/table/steel_reinforced,
/obj/item/clothing/shoes/terran,
/obj/item/clothing/shoes/terran,
/obj/item/clothing/shoes/terran,
/obj/item/clothing/shoes/terran,
/obj/item/clothing/shoes/terran,
/obj/item/clothing/shoes/terran,
/turf/simulated/floor/tiled/techfloor,
/area/space)
"x" = (
/obj/structure/table/steel_reinforced,
/obj/effect/floor_decal/techfloor{
	dir = 8;
	icon_state = "techfloor_edges"
	},
/obj/item/gun/projectile/automatic/sec_smg{
	magazine_type = /obj/item/ammo_magazine/smg_top
	},
/obj/item/gun/projectile/automatic/sec_smg{
	magazine_type = /obj/item/ammo_magazine/smg_top
	},
/turf/simulated/floor/tiled/techfloor,
/area/space)
"y" = (
/obj/structure/table/steel_reinforced,
/obj/item/clothing/head/terran/beret/grey,
/obj/item/clothing/head/terran/beret/grey,
/obj/item/clothing/head/terran/beret/grey,
/obj/item/clothing/head/terran/beret/grey,
/obj/item/clothing/head/terran/beret/grey,
/obj/item/clothing/head/terran/beret/grey,
/turf/simulated/floor/tiled/techfloor,
/area/space)
"z" = (
/obj/structure/table/steel_reinforced,
/obj/effect/floor_decal/techfloor{
	dir = 9;
	icon_state = "techfloor_edges"
	},
/obj/item/gun/projectile/automatic/machine_pistol,
/obj/item/gun/projectile/automatic/machine_pistol,
/turf/simulated/floor/tiled/techfloor,
/area/space)
"A" = (
/obj/machinery/door/airlock/glass/security{
	name = "Cell 1"
	},
/turf/simulated/floor/tiled/dark/monotile,
/area/space)
"B" = (
/obj/structure/table/steel_reinforced,
/obj/item/storage/belt/security,
/obj/item/storage/belt/security,
/obj/item/storage/belt/security,
/obj/item/storage/belt/security,
/obj/item/storage/belt/security,
/obj/item/storage/belt/security,
/turf/simulated/floor/tiled/techfloor,
/area/space)
"C" = (
/obj/machinery/light{
	dir = 1
	},
/obj/machinery/computer/modular/preset/security,
/turf/simulated/floor/tiled/techfloor,
/area/space)
"D" = (
/obj/structure/table/standard,
/obj/machinery/door/window/brigdoor/southleft,
/obj/machinery/door/window/brigdoor/northleft,
/obj/structure/window/reinforced{
	dir = 4
	},
/turf/simulated/floor/plating,
/area/space)
"E" = (
/turf/simulated/floor/tiled/techfloor,
/area/space)
"F" = (
/obj/machinery/door/airlock/glass/security{
	name = "Armory"
	},
/turf/simulated/floor/tiled/techfloor,
/area/space)
"G" = (
/obj/machinery/light{
	dir = 1
	},
/turf/simulated/floor/tiled/techfloor,
/area/space)
"H" = (
/obj/machinery/door/airlock/glass/security{
	name = "Cell 2"
	},
/turf/simulated/floor/tiled/dark/monotile,
/area/space)
"I" = (
/obj/structure/table/steel_reinforced,
/obj/effect/floor_decal/techfloor{
	dir = 6;
	icon_state = "techfloor_edges"
	},
/obj/item/ammo_magazine/proto_smg,
/obj/item/ammo_magazine/proto_smg,
/obj/item/ammo_magazine/proto_smg,
/obj/item/ammo_magazine/proto_smg,
/obj/item/ammo_magazine/proto_smg,
/obj/item/ammo_magazine/proto_smg,
/obj/item/ammo_magazine/proto_smg,
/obj/item/ammo_magazine/proto_smg,
/turf/simulated/floor/tiled/techfloor,
/area/space)
"J" = (
/obj/effect/floor_decal/spline/plain/red{
	dir = 6
	},
/turf/simulated/floor/tiled/dark/monotile,
/area/space)
"K" = (
/obj/effect/floor_decal/spline/plain/red{
	dir = 4
	},
/turf/simulated/floor/tiled/dark/monotile,
/area/space)
"L" = (
/obj/structure/hygiene/toilet,
/obj/effect/floor_decal/spline/plain/red{
	dir = 9
	},
/turf/simulated/floor/tiled/dark/monotile,
/area/space)
"M" = (
/obj/effect/floor_decal/spline/plain/red{
	dir = 10
	},
/turf/simulated/floor/tiled/dark/monotile,
/area/space)
"N" = (
/obj/structure/bed/chair/office/dark{
	dir = 1
	},
/turf/simulated/floor/tiled/techfloor,
/area/space)
"O" = (
/obj/structure/table/standard,
/obj/item/clothing/head/helmet/facecover{
	pixel_x = -4;
	pixel_y = -4
	},
/obj/item/clothing/head/helmet/facecover{
	pixel_x = -4;
	pixel_y = -4
	},
/obj/item/clothing/head/helmet/facecover{
	pixel_x = -4;
	pixel_y = -4
	},
/obj/item/handcuffs{
	pixel_x = 4;
	pixel_y = 8
	},
/obj/item/handcuffs{
	pixel_x = 4;
	pixel_y = 8
	},
/obj/item/handcuffs{
	pixel_x = 4;
	pixel_y = 8
	},
/turf/simulated/floor/tiled/dark,
/area/space)
"P" = (
/obj/structure/table/standard,
/turf/simulated/floor/tiled/dark,
/area/space)
"R" = (
/obj/structure/bed,
/obj/effect/floor_decal/spline/plain/red{
	dir = 5
	},
/obj/effect/submap_landmark/spawnpoint/rebel_hostage_spawn,
/turf/simulated/floor/tiled/dark/monotile,
/area/space)
"S" = (
/obj/machinery/door/airlock/glass/security{
	name = "Security"
	},
/turf/simulated/floor/tiled/dark/monotile,
/area/space)
"U" = (
/obj/effect/wallframe_spawn/reinforced,
/turf/simulated/floor/plating,
/area/space)
"V" = (
/obj/structure/table/steel_reinforced,
/obj/item/clothing/suit/armor/bulletproof,
/obj/item/clothing/suit/armor/bulletproof,
/obj/item/clothing/suit/armor/bulletproof,
/obj/item/clothing/suit/armor/bulletproof,
/obj/item/clothing/suit/armor/bulletproof,
/obj/item/clothing/suit/armor/bulletproof,
/turf/simulated/floor/tiled/techfloor,
/area/space)
"W" = (
/obj/structure/closet/secure_closet/security,
/turf/simulated/floor/tiled/techfloor,
/area/space)
"X" = (
/obj/effect/submap_landmark/joinable_submap/rebel_colony,
/turf/template_noop,
/area/space)
"Y" = (
/obj/machinery/light,
/obj/structure/table/standard,
/obj/item/material/knife/kitchen{
	pixel_x = -4
	},
/obj/item/material/knife/utility{
	pixel_x = 4
	},
/turf/simulated/floor/tiled/dark,
/area/space)

(1,1,1) = {"
X
a
a
a
a
a
a
a
a
a
a
a
a
a
a
a
a
a
a
a
a
a
a
a
a
a
a
a
a
a
a
a
a
a
a
a
a
a
a
a
a
a
a
a
a
a
a
a
a
a
a
a
a
a
a
a
a
a
a
a
"}
(2,1,1) = {"
a
a
a
a
a
a
a
a
a
a
a
a
a
a
a
a
a
a
a
a
a
a
a
a
a
a
a
a
a
a
a
a
a
a
a
a
a
a
a
a
a
a
a
a
a
a
a
a
a
a
a
a
a
a
a
a
a
a
a
a
"}
(3,1,1) = {"
a
a
a
a
a
a
a
a
a
a
a
a
a
a
a
a
a
a
a
a
a
a
a
a
a
a
a
a
a
a
a
a
a
a
a
a
a
a
a
a
a
a
a
a
a
a
a
a
a
a
a
a
a
a
a
a
a
a
a
a
"}
(4,1,1) = {"
a
a
a
a
a
r
r
r
r
r
r
r
r
r
r
r
r
r
r
a
a
a
a
a
a
a
a
a
a
a
a
a
a
a
a
a
a
a
a
a
a
a
a
a
a
a
a
a
a
a
a
a
a
a
a
a
a
a
a
a
"}
(5,1,1) = {"
a
a
a
a
a
r
L
u
M
D
q
q
O
r
W
W
W
W
r
a
a
a
a
a
a
a
a
a
a
a
a
a
a
a
a
a
a
a
a
a
a
a
a
a
a
a
a
a
a
a
a
a
a
a
a
a
a
a
a
a
"}
(6,1,1) = {"
a
a
a
a
a
r
R
K
J
A
j
j
Y
r
G
E
E
g
r
a
a
a
a
a
a
a
a
a
a
a
a
a
a
a
a
a
a
a
a
a
a
a
a
a
a
a
a
a
a
a
a
a
a
a
a
a
a
a
a
a
"}
(7,1,1) = {"
a
a
a
a
a
r
r
r
r
r
q
j
P
r
V
E
E
y
r
a
a
a
a
a
a
a
a
a
a
a
a
a
a
a
a
a
a
a
a
a
a
a
a
a
a
a
a
a
a
a
a
a
a
a
a
a
a
a
a
a
"}
(8,1,1) = {"
a
a
a
a
a
r
L
u
M
D
q
j
p
r
k
E
E
t
r
a
a
a
a
a
a
a
a
a
a
a
a
a
a
a
a
a
a
a
a
a
a
a
a
a
a
a
a
a
a
a
a
a
a
a
a
a
a
a
a
a
"}
(9,1,1) = {"
a
a
a
a
a
r
R
K
J
H
j
j
b
r
B
E
E
v
r
a
a
a
a
a
a
a
a
a
a
a
a
a
a
a
a
a
a
a
a
a
a
a
a
a
a
a
a
a
a
a
a
a
a
a
a
a
a
a
a
a
"}
(10,1,1) = {"
a
a
a
a
a
r
r
r
r
r
q
j
j
r
G
E
E
g
r
a
a
a
a
a
a
a
a
a
a
a
a
a
a
a
a
a
a
a
a
a
a
a
a
a
a
a
a
a
a
a
a
a
a
a
a
a
a
a
a
a
"}
(11,1,1) = {"
a
a
a
a
a
r
L
u
M
D
q
j
q
S
E
E
E
E
r
a
a
a
a
a
a
a
a
a
a
a
a
a
a
a
a
a
a
a
a
a
a
a
a
a
a
a
a
a
a
a
a
a
a
a
a
a
a
a
a
a
"}
(12,1,1) = {"
a
a
a
a
a
r
R
K
J
s
j
j
b
r
E
E
E
E
r
a
a
a
a
a
a
a
a
a
a
a
a
a
a
a
a
a
a
a
a
a
a
a
a
a
a
a
a
a
a
a
a
a
a
a
a
a
a
a
a
a
"}
(13,1,1) = {"
a
a
a
a
a
r
r
r
r
r
q
j
q
r
l
N
E
E
r
a
a
a
a
a
a
a
a
a
a
a
a
a
a
a
a
a
a
a
a
a
a
a
a
a
a
a
a
a
a
a
a
a
a
a
a
a
a
a
a
a
"}
(14,1,1) = {"
a
a
a
a
a
r
z
x
e
U
q
j
q
r
C
N
E
g
r
a
a
a
a
a
a
a
a
a
a
a
a
a
a
a
a
a
a
a
a
a
a
a
a
a
a
a
a
a
a
a
a
a
a
a
a
a
a
a
a
a
"}
(15,1,1) = {"
a
a
a
a
a
r
h
E
n
F
q
j
b
r
l
N
E
E
r
a
a
a
a
a
a
a
a
a
a
a
a
a
a
a
a
a
a
a
a
a
a
a
a
a
a
a
a
a
a
a
a
a
a
a
a
a
a
a
a
a
"}
(16,1,1) = {"
a
a
a
a
a
r
m
f
I
U
q
q
q
r
l
N
E
E
r
a
a
a
a
a
a
a
a
a
a
a
a
a
a
a
a
a
a
a
a
a
a
a
a
a
a
a
a
a
a
a
a
a
a
a
a
a
a
a
a
a
"}
(17,1,1) = {"
a
a
a
a
a
r
r
r
r
r
r
i
r
r
r
r
r
r
r
a
a
a
a
a
a
a
a
a
a
a
a
a
a
a
a
a
a
a
a
a
a
a
a
a
a
a
a
a
a
a
a
a
a
a
a
a
a
a
a
a
"}
(18,1,1) = {"
a
a
a
a
a
a
a
a
a
a
a
a
a
a
a
a
a
a
a
a
a
a
a
a
a
a
a
a
a
a
a
a
a
a
a
a
a
a
a
a
a
a
a
a
a
a
a
a
a
a
a
a
a
a
a
a
a
a
a
a
"}
(19,1,1) = {"
a
a
a
a
a
a
a
a
a
a
a
a
a
a
a
a
a
a
a
a
a
a
a
a
a
a
a
a
a
a
a
a
a
a
a
a
a
a
a
a
a
a
a
a
a
a
a
a
a
a
a
a
a
a
a
a
a
a
a
a
"}
(20,1,1) = {"
a
a
a
a
a
a
a
a
a
a
a
a
a
a
a
a
a
a
a
a
a
a
a
a
a
a
a
a
a
a
a
a
a
a
a
a
a
a
a
a
a
a
a
a
a
a
a
a
a
a
a
a
a
a
a
a
a
a
a
a
"}
(21,1,1) = {"
a
a
a
a
a
a
a
a
a
a
a
a
a
a
a
a
a
a
a
a
a
a
a
a
a
a
a
a
a
a
a
a
a
a
a
a
a
a
a
a
a
a
a
a
a
a
a
a
a
a
a
a
a
a
a
a
a
a
a
a
"}
(22,1,1) = {"
a
a
a
a
a
a
a
a
a
a
a
a
a
a
a
a
a
a
a
a
a
a
a
a
a
a
a
a
a
a
a
a
a
a
a
a
a
a
a
a
a
a
a
a
a
a
a
a
a
a
a
a
a
a
a
a
a
a
a
a
"}
(23,1,1) = {"
a
a
a
a
a
a
a
a
a
a
a
a
a
a
a
a
a
a
a
a
a
a
a
a
a
a
a
a
a
a
a
a
a
a
a
a
a
a
a
a
a
a
a
a
a
a
a
a
a
a
a
a
a
a
a
a
a
a
a
a
"}
(24,1,1) = {"
a
a
a
a
a
a
a
a
a
a
a
a
a
a
a
a
a
a
a
a
a
a
a
a
a
a
a
a
a
a
a
a
a
a
a
a
a
a
a
a
a
a
a
a
a
a
a
a
a
a
a
a
a
a
a
a
a
a
a
a
"}
(25,1,1) = {"
a
a
a
a
a
a
a
a
a
a
a
a
a
a
a
a
a
a
a
a
a
a
a
a
a
a
a
a
a
a
a
a
a
a
a
a
a
a
a
a
a
a
a
a
a
a
a
a
a
a
a
a
a
a
a
a
a
a
a
a
"}
(26,1,1) = {"
a
a
a
a
a
a
a
a
a
a
a
a
a
a
a
a
a
a
a
a
a
a
a
a
a
a
a
a
a
a
a
a
a
a
a
a
a
a
a
a
a
a
a
a
a
a
a
a
a
a
a
a
a
a
a
a
a
a
a
a
"}
(27,1,1) = {"
a
a
a
a
a
a
a
a
a
a
a
a
a
a
a
a
a
a
a
a
a
a
a
a
a
a
a
a
a
a
a
a
a
a
a
a
a
a
a
a
a
a
a
a
a
a
a
a
a
a
a
a
a
a
a
a
a
a
a
a
"}
(28,1,1) = {"
a
a
a
a
a
a
a
a
a
a
a
a
a
a
a
a
a
a
a
a
a
a
a
a
a
a
a
a
a
a
a
a
a
a
a
a
a
a
a
a
a
a
a
a
a
a
a
a
a
a
a
a
a
a
a
a
a
a
a
a
"}
(29,1,1) = {"
a
a
a
a
a
a
a
a
a
a
a
a
a
a
a
a
a
a
a
a
a
a
a
a
a
a
a
a
a
a
a
a
a
a
a
a
a
a
a
a
a
a
a
a
a
a
a
a
a
a
a
a
a
a
a
a
a
a
a
a
"}
(30,1,1) = {"
a
a
a
a
a
a
a
a
a
a
a
a
a
a
a
a
a
a
a
a
a
a
a
a
a
a
a
a
a
a
a
a
a
a
a
a
a
a
a
a
a
a
a
a
a
a
a
a
a
a
a
a
a
a
a
a
a
a
a
a
"}
(31,1,1) = {"
a
a
a
a
a
a
a
a
a
a
a
a
a
a
a
a
a
a
a
a
a
a
a
a
a
a
a
a
a
a
a
a
a
a
a
a
a
a
a
a
a
a
a
a
a
a
a
a
a
a
a
a
a
a
a
a
a
a
a
a
"}
(32,1,1) = {"
a
a
a
a
a
a
a
a
a
a
a
a
a
a
a
a
a
a
a
a
a
a
a
a
a
a
a
a
a
a
a
a
a
a
a
a
a
a
a
a
a
a
a
a
a
a
a
a
a
a
a
a
a
a
a
a
a
a
a
a
"}
(33,1,1) = {"
a
a
a
a
a
a
a
a
a
a
a
a
a
a
a
a
a
a
a
a
a
a
a
a
a
a
a
a
a
a
a
a
a
a
a
a
a
a
a
a
a
a
a
a
a
a
a
a
a
a
a
a
a
a
a
a
a
a
a
a
"}
(34,1,1) = {"
a
a
a
a
a
a
a
a
a
a
a
a
a
a
a
a
a
a
a
a
a
a
a
a
a
a
a
a
a
a
a
a
a
a
a
a
a
a
a
a
a
a
a
a
a
a
a
a
a
a
a
a
a
a
a
a
a
a
a
a
"}
(35,1,1) = {"
a
a
a
a
a
a
a
a
a
a
a
a
a
a
a
a
a
a
a
a
a
a
a
a
a
a
a
a
a
a
a
a
a
a
a
a
a
a
a
a
a
a
a
a
a
a
a
a
a
a
a
a
a
a
a
a
a
a
a
a
"}
(36,1,1) = {"
a
a
a
a
a
a
a
a
a
a
a
a
a
a
a
a
a
a
a
a
a
a
a
a
a
a
a
a
a
a
a
a
a
a
a
a
a
a
a
a
a
a
a
a
a
a
a
a
a
a
a
a
a
a
a
a
a
a
a
a
"}
(37,1,1) = {"
a
a
a
a
a
a
a
a
a
a
a
a
a
a
a
a
a
a
a
a
a
a
a
a
a
a
a
a
a
a
a
a
a
a
a
a
a
a
a
a
a
a
a
a
a
a
a
a
a
a
a
a
a
a
a
a
a
a
a
a
"}
(38,1,1) = {"
a
a
a
a
a
a
a
a
a
a
a
a
a
a
a
a
a
a
a
a
a
a
a
a
a
a
a
a
a
a
a
a
a
a
a
a
a
a
a
a
a
a
a
a
a
a
a
a
a
a
a
a
a
a
a
a
a
a
a
a
"}
(39,1,1) = {"
a
a
a
a
a
a
a
a
a
a
a
a
a
a
a
a
a
a
a
a
a
a
a
a
a
a
a
a
a
a
a
a
a
a
a
a
a
a
a
a
a
a
a
a
a
a
a
a
a
a
a
a
a
a
a
a
a
a
a
a
"}
(40,1,1) = {"
a
a
a
a
a
a
a
a
a
a
a
a
a
a
a
a
a
a
a
a
a
a
a
a
a
a
a
a
a
a
a
a
a
a
a
a
a
a
a
a
a
a
a
a
a
a
a
a
a
a
a
a
a
a
a
a
a
a
a
a
"}
(41,1,1) = {"
a
a
a
a
a
a
a
a
a
a
a
a
a
a
a
a
a
a
a
a
a
a
a
a
a
a
a
a
a
a
a
a
a
a
a
a
a
a
a
a
a
a
a
a
a
a
a
a
a
a
a
a
a
a
a
a
a
a
a
a
"}
(42,1,1) = {"
a
a
a
a
a
a
a
a
a
a
a
a
a
a
a
a
a
a
a
a
a
a
a
a
a
a
a
a
a
a
a
a
a
a
a
a
a
a
a
a
a
a
a
a
a
a
a
a
a
a
a
a
a
a
a
a
a
a
a
a
"}
(43,1,1) = {"
a
a
a
a
a
a
a
a
a
a
a
a
a
a
a
a
a
a
a
a
a
a
a
a
a
a
a
a
a
a
a
a
a
a
a
a
a
a
a
a
a
a
a
a
a
a
a
a
a
a
a
a
a
a
a
a
a
a
a
a
"}
(44,1,1) = {"
a
a
a
a
a
a
a
a
a
a
a
a
a
a
a
a
a
a
a
a
a
a
a
a
a
a
a
a
a
a
a
a
a
a
a
a
a
a
a
a
a
a
a
a
a
a
a
a
a
a
a
a
a
a
a
a
a
a
a
a
"}
(45,1,1) = {"
a
a
a
a
a
a
a
a
a
a
a
a
a
a
a
a
a
a
a
a
a
a
a
a
a
a
a
a
a
a
a
a
a
a
a
a
a
a
a
a
a
a
a
a
a
a
a
a
a
a
a
a
a
a
a
a
a
a
a
a
"}
(46,1,1) = {"
a
a
a
a
a
a
a
a
a
a
a
a
a
a
a
a
a
a
a
a
a
a
a
a
a
a
a
a
a
a
a
a
a
a
a
a
a
a
a
a
a
a
a
a
a
a
a
a
a
a
a
a
a
a
a
a
a
a
a
a
"}
(47,1,1) = {"
a
a
a
a
a
a
a
a
a
a
a
a
a
a
a
a
a
a
a
a
a
a
a
a
a
a
a
a
a
a
a
a
a
a
a
a
a
a
a
a
a
a
a
a
a
a
a
a
a
a
a
a
a
a
a
a
a
a
a
a
"}
(48,1,1) = {"
a
a
a
a
a
a
a
a
a
a
a
a
a
a
a
a
a
a
a
a
a
a
a
a
a
a
a
a
a
a
a
a
a
a
a
a
a
a
a
a
a
a
a
a
a
a
a
a
a
a
a
a
a
a
a
a
a
a
a
a
"}
(49,1,1) = {"
a
a
a
a
a
a
a
a
a
a
a
a
a
a
a
a
a
a
a
a
a
a
a
a
a
a
a
a
a
a
a
a
a
a
a
a
a
a
a
a
a
a
a
a
a
a
a
a
a
a
a
a
a
a
a
a
a
a
a
a
"}
(50,1,1) = {"
a
a
a
a
a
a
a
a
a
a
a
a
a
a
a
a
a
a
a
a
a
a
a
a
a
a
a
a
a
a
a
a
a
a
a
a
a
a
a
a
a
a
a
a
a
a
a
a
a
a
a
a
a
a
a
a
a
a
a
a
"}
(51,1,1) = {"
a
a
a
a
a
a
a
a
a
a
a
a
a
a
a
a
a
a
a
a
a
a
a
a
a
a
a
a
a
a
a
a
a
a
a
a
a
a
a
a
a
a
a
a
a
a
a
a
a
a
a
a
a
a
a
a
a
a
a
a
"}
(52,1,1) = {"
a
a
a
a
a
a
a
a
a
a
a
a
a
a
a
a
a
a
a
a
a
a
a
a
a
a
a
a
a
a
a
a
a
a
a
a
a
a
a
a
a
a
a
a
a
a
a
a
a
a
a
a
a
a
a
a
a
a
a
a
"}
(53,1,1) = {"
a
a
a
a
a
a
a
a
a
a
a
a
a
a
a
a
a
a
a
a
a
a
a
a
a
a
a
a
a
a
a
a
a
a
a
a
a
a
a
a
a
a
a
a
a
a
a
a
a
a
a
a
a
a
a
a
a
a
a
a
"}
(54,1,1) = {"
a
a
a
a
a
a
a
a
a
a
a
a
a
a
a
a
a
a
a
a
a
a
a
a
a
a
a
a
a
a
a
a
a
a
a
a
a
a
a
a
a
a
a
a
a
a
a
a
a
a
a
a
a
a
a
a
a
a
a
a
"}
(55,1,1) = {"
a
a
a
a
a
a
a
a
a
a
a
a
a
a
a
a
a
a
a
a
a
a
a
a
a
a
a
a
a
a
a
a
a
a
a
a
a
a
a
a
a
a
a
a
a
a
a
a
a
a
a
a
a
a
a
a
a
a
a
a
"}
(56,1,1) = {"
a
a
a
a
a
a
a
a
a
a
a
a
a
a
a
a
a
a
a
a
a
a
a
a
a
a
a
a
a
a
a
a
a
a
a
a
a
a
a
a
a
a
a
a
a
a
a
a
a
a
a
a
a
a
a
a
a
a
a
a
"}
(57,1,1) = {"
a
a
a
a
a
a
a
a
a
a
a
a
a
a
a
a
a
a
a
a
a
a
a
a
a
a
a
a
a
a
a
a
a
a
a
a
a
a
a
a
a
a
a
a
a
a
a
a
a
a
a
a
a
a
a
a
a
a
a
a
"}
(58,1,1) = {"
a
a
a
a
a
a
a
a
a
a
a
a
a
a
a
a
a
a
a
a
a
a
a
a
a
a
a
a
a
a
a
a
a
a
a
a
a
a
a
a
a
a
a
a
a
a
a
a
a
a
a
a
a
a
a
a
a
a
a
a
"}
(59,1,1) = {"
a
a
a
a
a
a
a
a
a
a
a
a
a
a
a
a
a
a
a
a
a
a
a
a
a
a
a
a
a
a
a
a
a
a
a
a
a
a
a
a
a
a
a
a
a
a
a
a
a
a
a
a
a
a
a
a
a
a
a
a
"}
(60,1,1) = {"
a
a
a
a
a
a
a
a
a
a
a
a
a
a
a
a
a
a
a
a
a
a
a
a
a
a
a
a
a
a
a
a
a
a
a
a
a
a
a
a
a
a
a
a
a
a
a
a
a
a
a
a
a
a
a
a
a
a
a
a
"}
