//MAP CONVERTED BY dmm2tgm.py THIS HEADER COMMENT PREVENTS RECONVERSION, DO NOT REMOVE
"a" = (
/turf/template_noop,
/area/abandoned_bunker/bunker/storage)
"c" = (
/turf/simulated/floor/tiled/techmaint,
/area/abandoned_bunker/bunker/storage)
"e" = (
/obj/machinery/light{
	dir = 1
	},
/turf/simulated/floor/tiled/steel_grid,
/area/abandoned_bunker/bunker/storage)
"f" = (
/obj/structure/table/rack,
/obj/structure/cable/cyan{
	icon_state = "4-8"
	},
/obj/random/trash,
/turf/simulated/floor/tiled/techmaint,
/area/abandoned_bunker/bunker/storage)
"j" = (
/obj/structure/table/rack,
/obj/item/stack/cable_coil/cyan,
/turf/simulated/floor/tiled/techmaint,
/area/abandoned_bunker/bunker/storage)
"k" = (
/obj/machinery/power/apc{
	dir = 4;
	pixel_x = 24
	},
/obj/machinery/power/terminal{
	dir = 4
	},
/obj/structure/cable/cyan{
	icon_state = "0-8"
	},
/turf/simulated/floor/tiled/steel_grid,
/area/abandoned_bunker/bunker/storage)
"n" = (
/obj/structure/table/rack,
/obj/item/stack/material/aluminium/fifty,
/turf/simulated/floor/tiled/techmaint,
/area/abandoned_bunker/bunker/storage)
"o" = (
/obj/structure/table/rack,
/obj/structure/cable/cyan{
	icon_state = "4-8"
	},
/turf/simulated/floor/tiled/techmaint,
/area/abandoned_bunker/bunker/storage)
"q" = (
/obj/structure/table/rack,
/obj/item/stack/material/steel/fifty,
/turf/simulated/floor/tiled/techmaint,
/area/abandoned_bunker/bunker/storage)
"s" = (
/obj/structure/cable/cyan{
	icon_state = "4-8"
	},
/turf/simulated/floor/tiled/steel_grid,
/area/abandoned_bunker/bunker/storage)
"t" = (
/obj/structure/table/rack,
/obj/structure/cable/cyan{
	icon_state = "4-8"
	},
/obj/random/junk,
/turf/simulated/floor/tiled/techmaint,
/area/abandoned_bunker/bunker/storage)
"v" = (
/obj/random/trash,
/turf/simulated/floor/tiled/steel_grid,
/area/abandoned_bunker/bunker/storage)
"w" = (
/obj/structure/table/rack,
/obj/random/junk,
/turf/simulated/floor/tiled/techmaint,
/area/abandoned_bunker/bunker/storage)
"A" = (
/obj/structure/table/rack,
/obj/structure/cable/cyan{
	icon_state = "4-8"
	},
/obj/random/junk,
/obj/random/junk,
/turf/simulated/floor/tiled/techmaint,
/area/abandoned_bunker/bunker/storage)
"E" = (
/obj/structure/table/rack,
/obj/item/stack/material/glass/fifty,
/turf/simulated/floor/tiled/techmaint,
/area/abandoned_bunker/bunker/storage)
"G" = (
/obj/machinery/light,
/turf/simulated/floor/tiled/steel_grid,
/area/abandoned_bunker/bunker/storage)
"I" = (
/obj/random/trash,
/turf/simulated/floor/tiled/techmaint,
/area/abandoned_bunker/bunker/storage)
"O" = (
/turf/simulated/floor/tiled/steel_grid,
/area/abandoned_bunker/bunker/storage)
"Q" = (
/obj/machinery/door/airlock/engineering{
	name = "Main Storage"
	},
/turf/simulated/floor/tiled/steel_grid,
/area/abandoned_bunker/bunker/storage)
"S" = (
/obj/structure/table/rack,
/obj/item/stack/material/plastic/fifty,
/turf/simulated/floor/tiled/techmaint,
/area/abandoned_bunker/bunker/storage)
"X" = (
/obj/structure/table/rack,
/obj/structure/cable/cyan{
	icon_state = "4-8"
	},
/obj/item/stack/material/plasteel/ten,
/turf/simulated/floor/tiled/techmaint,
/area/abandoned_bunker/bunker/storage)

(1,1,1) = {"
a
a
a
a
Q
a
a
a
a
"}
(2,1,1) = {"
a
v
O
O
s
O
O
O
a
"}
(3,1,1) = {"
a
O
j
c
A
c
w
O
a
"}
(4,1,1) = {"
a
O
n
I
o
c
c
O
a
"}
(5,1,1) = {"
a
e
E
c
t
c
c
G
a
"}
(6,1,1) = {"
a
O
S
c
f
c
c
O
a
"}
(7,1,1) = {"
a
O
q
c
X
I
w
O
a
"}
(8,1,1) = {"
a
O
O
O
k
O
O
v
a
"}
(9,1,1) = {"
a
a
a
a
a
a
a
a
a
"}
