//MAP CONVERTED BY dmm2tgm.py THIS HEADER COMMENT PREVENTS RECONVERSION, DO NOT REMOVE
"a" = (
/turf/template_noop,
/area/template_noop)
"b" = (
/obj/effect/floor_decal/corner/yellow/border,
/turf/simulated/floor/tiled,
/area/template_noop)
"c" = (
/turf/simulated/wall/r_titanium,
/area/template_noop)
"d" = (
/obj/effect/floor_decal/corner/yellow/border{
	dir = 1
	},
/obj/structure/table/steel,
/turf/simulated/floor/tiled,
/area/template_noop)
"e" = (
/obj/structure/cable/cyan{
	icon_state = "4-8"
	},
/turf/simulated/floor/exoplanet/flesh,
/area/template_noop)
"f" = (
/obj/structure/cable/cyan{
	icon_state = "1-2"
	},
/turf/simulated/floor/tiled,
/area/template_noop)
"g" = (
/obj/item/material/shard,
/turf/simulated/floor/tiled,
/area/template_noop)
"i" = (
/obj/effect/floor_decal/corner/yellow/border{
	dir = 1
	},
/obj/machinery/light{
	dir = 1
	},
/turf/simulated/floor/tiled,
/area/template_noop)
"j" = (
/obj/structure/cable/cyan{
	icon_state = "1-2"
	},
/obj/structure/cable/cyan{
	icon_state = "1-8"
	},
/obj/effect/gibspawner/generic,
/turf/simulated/floor/tiled,
/area/template_noop)
"l" = (
/turf/simulated/floor/tiled,
/area/template_noop)
"m" = (
/obj/effect/floor_decal/corner/yellow/border{
	dir = 1
	},
/turf/simulated/floor/tiled,
/area/template_noop)
"n" = (
/obj/effect/floor_decal/corner/yellow/border{
	dir = 8
	},
/obj/item/material/shard,
/turf/simulated/floor/tiled,
/area/template_noop)
"o" = (
/obj/item/material/shard,
/turf/simulated/floor/exoplanet/flesh,
/area/template_noop)
"p" = (
/mob/living/simple_animal/hostile/infestation/broodling,
/obj/effect/gibspawner/generic,
/turf/simulated/floor/exoplanet/flesh,
/area/template_noop)
"s" = (
/obj/effect/floor_decal/corner/yellow/border{
	dir = 4
	},
/obj/effect/landmark/corpse/engineer{
	brute_loss = 5000
	},
/turf/simulated/floor/tiled,
/area/template_noop)
"t" = (
/obj/machinery/power/apc{
	dir = 1;
	pixel_y = 24
	},
/obj/machinery/power/terminal{
	dir = 1
	},
/obj/structure/cable/cyan{
	icon_state = "0-2"
	},
/mob/living/simple_animal/hostile/infestation/larva/implant/implanter,
/obj/item/material/shard,
/turf/simulated/floor/exoplanet/flesh,
/area/template_noop)
"u" = (
/obj/effect/floor_decal/corner/yellow/border{
	dir = 8
	},
/obj/machinery/light{
	dir = 8
	},
/turf/simulated/floor/tiled,
/area/template_noop)
"v" = (
/obj/effect/floor_decal/corner/yellow/border,
/obj/structure/table/steel,
/obj/item/stack/material/uranium/ten,
/obj/machinery/power/terminal{
	dir = 4
	},
/obj/structure/cable/cyan{
	icon_state = "0-8"
	},
/turf/simulated/floor/tiled,
/area/template_noop)
"w" = (
/obj/effect/floor_decal/corner/yellow/border{
	dir = 8
	},
/mob/living/simple_animal/hostile/infestation/broodling,
/obj/effect/gibspawner/generic,
/turf/simulated/floor/tiled,
/area/template_noop)
"x" = (
/obj/effect/floor_decal/corner/yellow/border{
	dir = 6
	},
/obj/machinery/power/port_gen/pacman/super/potato/reactor,
/obj/structure/cable/cyan{
	icon_state = "0-8"
	},
/turf/simulated/floor/tiled,
/area/template_noop)
"y" = (
/obj/structure/cable/cyan{
	icon_state = "1-2"
	},
/obj/item/material/shard,
/turf/simulated/floor/exoplanet/flesh,
/area/template_noop)
"z" = (
/mob/living/simple_animal/hostile/infestation/broodling,
/turf/simulated/floor/exoplanet/flesh,
/area/template_noop)
"A" = (
/obj/effect/floor_decal/corner/yellow/border{
	dir = 4
	},
/turf/simulated/floor/tiled,
/area/template_noop)
"B" = (
/obj/effect/floor_decal/corner/yellow/border,
/mob/living/simple_animal/hostile/infestation/broodling,
/turf/simulated/floor/tiled,
/area/template_noop)
"C" = (
/obj/structure/cable/cyan{
	icon_state = "4-8"
	},
/obj/effect/gibspawner/generic,
/turf/simulated/floor/tiled,
/area/template_noop)
"D" = (
/obj/effect/floor_decal/corner/yellow/border{
	dir = 10
	},
/obj/effect/landmark/corpse/engineer{
	brute_loss = 5000
	},
/turf/simulated/floor/tiled,
/area/template_noop)
"E" = (
/obj/structure/cable/cyan{
	icon_state = "2-4"
	},
/turf/simulated/floor/tiled,
/area/template_noop)
"F" = (
/obj/machinery/door/airlock/engineering{
	name = "Engineering Department"
	},
/obj/structure/cable/cyan{
	icon_state = "4-8"
	},
/turf/simulated/floor/tiled,
/area/template_noop)
"G" = (
/obj/structure/cable/cyan{
	icon_state = "4-8"
	},
/mob/living/simple_animal/hostile/infestation/broodling,
/turf/simulated/floor/tiled,
/area/template_noop)
"H" = (
/mob/living/simple_animal/hostile/infestation/broodling,
/obj/item/material/shard,
/turf/simulated/floor/exoplanet/flesh,
/area/template_noop)
"I" = (
/mob/living/simple_animal/hostile/infestation/broodling,
/turf/simulated/floor/tiled,
/area/template_noop)
"J" = (
/obj/effect/floor_decal/corner/yellow/border,
/obj/machinery/light,
/obj/structure/table/steel,
/obj/item/stack/material/uranium/ten,
/obj/machinery/power/terminal{
	dir = 8
	},
/obj/structure/cable/cyan{
	icon_state = "0-4"
	},
/turf/simulated/floor/tiled,
/area/template_noop)
"K" = (
/obj/effect/floor_decal/corner/yellow/border{
	dir = 8
	},
/obj/structure/cable/cyan{
	icon_state = "4-8"
	},
/turf/simulated/floor/tiled,
/area/template_noop)
"L" = (
/obj/structure/cable/cyan{
	icon_state = "1-8"
	},
/obj/structure/cable/cyan{
	icon_state = "2-8"
	},
/turf/simulated/floor/exoplanet/flesh,
/area/template_noop)
"M" = (
/obj/effect/floor_decal/corner/yellow/border,
/obj/machinery/power/smes/buildable,
/obj/structure/cable/cyan,
/turf/simulated/floor/tiled,
/area/template_noop)
"N" = (
/mob/living/simple_animal/hostile/infestation/broodling,
/obj/effect/landmark/corpse/engineer{
	brute_loss = 5000
	},
/turf/simulated/floor/exoplanet/flesh,
/area/template_noop)
"P" = (
/obj/effect/floor_decal/corner/yellow/border{
	dir = 9
	},
/obj/structure/table/steel,
/turf/simulated/floor/tiled,
/area/template_noop)
"Q" = (
/obj/structure/cable/cyan{
	icon_state = "4-8"
	},
/turf/simulated/floor/tiled,
/area/template_noop)
"S" = (
/mob/living/simple_animal/hostile/infestation/larva/implant/implanter,
/turf/simulated/floor/exoplanet/flesh,
/area/template_noop)
"T" = (
/obj/structure/cable/cyan{
	icon_state = "4-8"
	},
/mob/living/simple_animal/hostile/infestation/broodling,
/turf/simulated/floor/exoplanet/flesh,
/area/template_noop)
"U" = (
/obj/effect/floor_decal/corner/yellow/border{
	dir = 10
	},
/obj/machinery/power/port_gen/pacman/super/potato/reactor,
/obj/structure/cable/cyan{
	icon_state = "0-4"
	},
/turf/simulated/floor/tiled,
/area/template_noop)
"V" = (
/obj/structure/cable/cyan{
	icon_state = "1-2"
	},
/turf/simulated/floor/exoplanet/flesh,
/area/template_noop)
"X" = (
/obj/structure/cable/cyan{
	icon_state = "4-8"
	},
/obj/effect/gibspawner/generic,
/turf/simulated/floor/exoplanet/flesh,
/area/template_noop)
"Y" = (
/obj/effect/floor_decal/corner/yellow/border{
	dir = 8
	},
/obj/effect/landmark/corpse/engineer{
	brute_loss = 5000
	},
/turf/simulated/floor/tiled,
/area/template_noop)
"Z" = (
/turf/simulated/floor/exoplanet/flesh,
/area/template_noop)

(1,1,1) = {"
c
c
F
c
c
a
a
a
a
a
"}
(2,1,1) = {"
c
P
K
D
c
a
a
a
a
a
"}
(3,1,1) = {"
c
d
Q
b
c
a
a
a
a
a
"}
(4,1,1) = {"
c
d
Q
b
c
a
a
a
a
a
"}
(5,1,1) = {"
c
i
C
b
c
a
a
a
a
a
"}
(6,1,1) = {"
c
m
Q
b
c
a
a
a
a
a
"}
(7,1,1) = {"
c
Z
G
b
c
a
a
a
a
a
"}
(8,1,1) = {"
c
N
Q
B
c
a
a
a
a
a
"}
(9,1,1) = {"
c
Z
e
b
c
c
c
c
c
c
"}
(10,1,1) = {"
c
m
e
Z
n
w
u
Y
U
c
"}
(11,1,1) = {"
c
i
T
g
g
l
Z
Z
v
c
"}
(12,1,1) = {"
c
m
X
Z
l
Z
o
E
M
c
"}
(13,1,1) = {"
c
t
L
V
V
y
f
j
M
c
"}
(14,1,1) = {"
c
Z
Z
H
Z
z
l
I
J
c
"}
(15,1,1) = {"
c
Z
Z
S
o
A
s
A
x
c
"}
(16,1,1) = {"
c
c
p
c
c
c
c
c
c
c
"}
