//MAP CONVERTED BY dmm2tgm.py THIS HEADER COMMENT PREVENTS RECONVERSION, DO NOT REMOVE
"a" = (
/turf/simulated/mineral/random/high_chance{
	initial_gas = list("oxygen" = 21.8366, "nitrogen" = 82.1472)
	},
/area/template_noop)
"c" = (
/mob/living/simple_animal/hostile/antlion/mega,
/turf/simulated/floor/asteroid{
	initial_gas = list("oxygen" = 21.8366, "nitrogen" = 82.1472)
	},
/area/template_noop)
"A" = (
/obj/random/ore,
/turf/simulated/floor/asteroid{
	initial_gas = list("oxygen" = 21.8366, "nitrogen" = 82.1472)
	},
/area/template_noop)
"B" = (
/obj/effect/gibspawner/generic,
/turf/simulated/floor/asteroid{
	initial_gas = list("oxygen" = 21.8366, "nitrogen" = 82.1472)
	},
/area/template_noop)
"G" = (
/obj/effect/landmark/corpse/miner,
/obj/effect/gibspawner/generic,
/turf/simulated/floor/asteroid{
	initial_gas = list("oxygen" = 21.8366, "nitrogen" = 82.1472)
	},
/area/template_noop)
"H" = (
/turf/simulated/floor/asteroid{
	initial_gas = list("oxygen" = 21.8366, "nitrogen" = 82.1472)
	},
/area/template_noop)
"P" = (
/mob/living/simple_animal/hostile/antlion,
/turf/simulated/floor/asteroid{
	initial_gas = list("oxygen" = 21.8366, "nitrogen" = 82.1472)
	},
/area/template_noop)

(1,1,1) = {"
a
a
a
a
a
H
H
H
H
a
a
a
a
a
"}
(2,1,1) = {"
a
a
H
H
P
H
H
H
H
H
H
H
a
a
"}
(3,1,1) = {"
a
H
H
H
H
H
A
H
H
H
H
H
H
a
"}
(4,1,1) = {"
a
H
H
H
H
H
H
H
H
H
P
H
H
H
"}
(5,1,1) = {"
a
H
H
H
H
H
H
H
H
H
H
H
H
H
"}
(6,1,1) = {"
H
H
P
H
H
H
H
P
H
H
H
H
B
H
"}
(7,1,1) = {"
H
H
H
H
H
A
H
H
H
H
G
A
H
H
"}
(8,1,1) = {"
H
H
H
H
H
H
H
H
H
H
H
H
H
H
"}
(9,1,1) = {"
H
A
H
H
H
P
H
H
H
P
H
H
B
H
"}
(10,1,1) = {"
H
H
H
H
H
H
H
H
H
H
H
H
H
B
"}
(11,1,1) = {"
H
H
H
H
c
H
H
P
H
H
H
H
H
H
"}
(12,1,1) = {"
H
H
P
H
H
H
H
H
H
H
P
H
A
H
"}
(13,1,1) = {"
H
H
H
H
H
H
H
H
H
H
H
B
H
G
"}
(14,1,1) = {"
a
H
H
H
H
H
H
A
H
H
H
H
H
H
"}
(15,1,1) = {"
a
H
H
P
H
H
H
H
H
H
P
H
P
H
"}
(16,1,1) = {"
a
H
H
H
H
H
H
H
H
H
H
H
H
a
"}
(17,1,1) = {"
a
a
H
H
H
H
H
P
H
H
H
A
H
a
"}
(18,1,1) = {"
a
a
H
A
H
H
H
H
H
H
H
H
a
a
"}
(19,1,1) = {"
a
a
a
H
H
H
H
H
H
H
H
a
a
a
"}
(20,1,1) = {"
a
a
a
a
a
a
H
H
a
a
a
a
a
a
"}
