//MAP CONVERTED BY dmm2tgm.py THIS HEADER COMMENT PREVENTS RECONVERSION, DO NOT REMOVE
"a" = (
/turf/template_noop,
/area/template_noop)
"b" = (
/obj/machinery/vending/soda,
/turf/simulated/floor/wood/maple,
/area/template_noop)
"f" = (
/obj/machinery/vending/snack,
/obj/effect/decal/cleanable/dirt,
/turf/simulated/floor/wood/maple,
/area/template_noop)
"g" = (
/obj/effect/decal/cleanable/dirt,
/turf/simulated/floor/wood/maple,
/area/template_noop)
"i" = (
/obj/structure/bed/chair/wood{
	dir = 1
	},
/obj/effect/decal/cleanable/dirt,
/turf/simulated/floor/wood/maple{
	icon_state = "wood_broken0"
	},
/area/template_noop)
"j" = (
/obj/effect/decal/cleanable/blood/splatter,
/turf/simulated/floor/wood/maple{
	icon_state = "wood_broken1"
	},
/area/template_noop)
"k" = (
/obj/effect/decal/cleanable/dirt,
/obj/machinery/light{
	dir = 8
	},
/turf/simulated/floor/wood/maple,
/area/template_noop)
"l" = (
/obj/structure/bed/chair/wood,
/turf/simulated/floor/wood/maple,
/area/template_noop)
"r" = (
/obj/item/ammo_casing/pistol/used{
	pixel_x = -5;
	pixel_y = 3
	},
/obj/item/ammo_casing/pistol/used{
	pixel_x = -10;
	pixel_y = -14
	},
/obj/item/ammo_casing/pistol/used{
	pixel_x = 5;
	pixel_y = -3
	},
/obj/item/ammo_casing/pistol/used{
	pixel_x = -2;
	pixel_y = 5
	},
/obj/item/ammo_casing/pistol/used,
/obj/effect/decal/cleanable/blood/drip{
	pixel_y = 10
	},
/obj/effect/decal/cleanable/dirt,
/turf/simulated/floor/wood/maple,
/area/template_noop)
"s" = (
/obj/structure/table/woodentable,
/obj/item/trash/cakewrap,
/turf/simulated/floor/wood/maple,
/area/template_noop)
"t" = (
/obj/structure/table/woodentable,
/obj/item/reagent_containers/food/snacks/canned/caviar{
	pixel_x = 11;
	pixel_y = 7
	},
/obj/effect/decal/cleanable/dirt,
/turf/simulated/floor/wood/maple,
/area/template_noop)
"u" = (
/obj/item/ammo_casing/pistol/used{
	pixel_x = 5;
	pixel_y = -7
	},
/obj/effect/decal/cleanable/dirt,
/turf/simulated/floor/wood/maple,
/area/template_noop)
"w" = (
/obj/effect/decal/cleanable/blood/drip{
	pixel_x = -13;
	pixel_y = -5
	},
/obj/effect/decal/cleanable/blood/drip{
	pixel_y = 14
	},
/obj/effect/decal/cleanable/dirt,
/turf/simulated/floor/wood/maple,
/area/template_noop)
"z" = (
/turf/simulated/floor/wood/maple,
/area/template_noop)
"A" = (
/obj/structure/table/woodentable,
/turf/simulated/floor/wood/maple,
/area/template_noop)
"B" = (
/obj/structure/bed/chair/wood{
	dir = 1
	},
/obj/effect/decal/cleanable/blood/splatter,
/turf/simulated/floor/wood/maple,
/area/template_noop)
"C" = (
/obj/item/trash/beans,
/obj/effect/decal/cleanable/blood/splatter,
/obj/effect/decal/cleanable/dirt,
/turf/simulated/floor/wood/maple,
/area/template_noop)
"D" = (
/obj/structure/table/woodentable,
/obj/item/stack/medical/advanced/bruise_pack{
	amount = 2;
	pixel_x = -6;
	pixel_y = 8
	},
/obj/effect/decal/cleanable/dirt,
/turf/simulated/floor/wood/maple,
/area/template_noop)
"E" = (
/obj/effect/decal/cleanable/blood/drip,
/obj/effect/decal/cleanable/dirt,
/turf/simulated/floor/wood/maple,
/area/template_noop)
"H" = (
/turf/simulated/floor/wood/maple{
	icon_state = "wood_broken6"
	},
/area/template_noop)
"I" = (
/obj/machinery/door/airlock/glass/security,
/obj/effect/decal/cleanable/blood/drip{
	pixel_x = -9
	},
/turf/simulated/floor/wood/maple,
/area/template_noop)
"M" = (
/obj/structure/table/woodentable,
/obj/item/trash/cheesie,
/turf/simulated/floor/wood/maple,
/area/template_noop)
"O" = (
/obj/structure/table/woodentable,
/obj/random/mre/drink{
	pixel_x = 14
	},
/turf/simulated/floor/wood/maple,
/area/template_noop)
"Q" = (
/obj/effect/decal/cleanable/blood,
/obj/effect/decal/cleanable/dirt,
/turf/simulated/floor/wood/maple,
/area/template_noop)
"T" = (
/obj/item/ammo_casing/pistol/used{
	pixel_x = -9;
	pixel_y = 7
	},
/obj/effect/decal/cleanable/dirt,
/turf/simulated/floor/wood/maple,
/area/template_noop)
"V" = (
/obj/structure/table/woodentable,
/obj/effect/decal/cleanable/dirt,
/obj/machinery/light_construct{
	dir = 4
	},
/turf/simulated/floor/wood/maple,
/area/template_noop)
"W" = (
/obj/structure/bed/chair/wood,
/turf/simulated/floor/wood/maple{
	icon_state = "wood_broken5"
	},
/area/template_noop)

(1,1,1) = {"
a
a
a
a
a
a
"}
(2,1,1) = {"
a
O
H
k
f
a
"}
(3,1,1) = {"
a
s
B
z
b
a
"}
(4,1,1) = {"
a
g
Q
j
z
a
"}
(5,1,1) = {"
I
w
E
Q
C
a
"}
(6,1,1) = {"
a
g
D
u
r
a
"}
(7,1,1) = {"
a
W
A
t
T
a
"}
(8,1,1) = {"
a
l
M
V
i
a
"}
(9,1,1) = {"
a
a
a
a
a
a
"}
