//MAP CONVERTED BY dmm2tgm.py THIS HEADER COMMENT PREVENTS RECONVERSION, DO NOT REMOVE
"a" = (
/turf/template_noop,
/area/template_noop)
"d" = (
/obj/machinery/door/airlock/civilian,
/turf/simulated/floor/tiled/monotile,
/area/template_noop)
"j" = (
/obj/structure/filingcabinet/chestdrawer,
/turf/simulated/floor/tiled/monotile,
/area/template_noop)
"t" = (
/obj/structure/bed/chair/office/light{
	dir = 1
	},
/turf/simulated/floor/tiled/monotile,
/area/template_noop)
"C" = (
/obj/structure/table/reinforced,
/obj/structure/flora/pottedplant/small{
	pixel_y = 12
	},
/turf/simulated/floor/tiled/monotile,
/area/template_noop)
"E" = (
/obj/structure/table/reinforced,
/obj/item/paper,
/turf/simulated/floor/tiled/monotile,
/area/template_noop)
"H" = (
/turf/simulated/floor/tiled/monotile,
/area/template_noop)
"N" = (
/obj/machinery/light/small{
	dir = 4
	},
/turf/simulated/floor/tiled/monotile,
/area/template_noop)
"Q" = (
/obj/structure/table/reinforced,
/obj/item/device/flashlight/lamp{
	pixel_y = 8
	},
/turf/simulated/floor/tiled/monotile,
/area/template_noop)
"R" = (
/obj/structure/bed,
/obj/item/bedsheet/brown,
/turf/simulated/floor/tiled/monotile,
/area/template_noop)

(1,1,1) = {"
a
a
a
a
a
a
"}
(2,1,1) = {"
a
Q
H
H
C
a
"}
(3,1,1) = {"
a
E
t
H
H
d
"}
(4,1,1) = {"
a
R
H
N
j
a
"}
(5,1,1) = {"
a
a
a
a
a
a
"}
