//MAP CONVERTED BY dmm2tgm.py THIS HEADER COMMENT PREVENTS RECONVERSION, DO NOT REMOVE
"a" = (
/turf/template_noop,
/area/abandoned_bunker/bunker/storage)
"c" = (
/obj/structure/cable/cyan{
	icon_state = "4-8"
	},
/turf/simulated/floor/tiled/steel_grid,
/area/abandoned_bunker/bunker/storage)
"d" = (
/obj/structure/table/rack,
/obj/item/stack/material/plastic/fifty,
/obj/item/stack/material/plastic/fifty,
/obj/item/stack/material/plastic/fifty,
/turf/simulated/floor/tiled/techmaint,
/area/abandoned_bunker/bunker/storage)
"e" = (
/obj/machinery/light,
/turf/simulated/floor/tiled/steel_grid,
/area/abandoned_bunker/bunker/storage)
"g" = (
/obj/structure/table/rack,
/obj/structure/cable/cyan{
	icon_state = "4-8"
	},
/obj/item/stack/material/titanium/ten,
/turf/simulated/floor/tiled/techmaint,
/area/abandoned_bunker/bunker/storage)
"k" = (
/obj/machinery/power/apc{
	dir = 4;
	pixel_x = 24
	},
/obj/machinery/power/terminal{
	dir = 4
	},
/obj/structure/cable/cyan{
	icon_state = "0-8"
	},
/turf/simulated/floor/tiled/steel_grid,
/area/abandoned_bunker/bunker/storage)
"o" = (
/obj/structure/table/rack,
/obj/item/stack/material/aluminium/fifty,
/obj/item/stack/material/aluminium/fifty,
/obj/item/stack/material/aluminium/fifty,
/turf/simulated/floor/tiled/techmaint,
/area/abandoned_bunker/bunker/storage)
"r" = (
/obj/structure/table/rack,
/obj/item/stack/cable_coil/cyan,
/obj/item/stack/cable_coil/cyan,
/obj/item/stack/cable_coil/cyan,
/obj/item/stack/cable_coil/cyan,
/obj/item/stack/cable_coil/cyan,
/obj/item/stack/cable_coil/cyan,
/obj/item/stack/cable_coil/cyan,
/obj/item/stack/cable_coil/cyan,
/obj/item/stack/cable_coil/cyan,
/obj/item/stack/cable_coil/cyan,
/turf/simulated/floor/tiled/techmaint,
/area/abandoned_bunker/bunker/storage)
"s" = (
/turf/simulated/floor/tiled/steel_grid,
/area/abandoned_bunker/bunker/storage)
"u" = (
/turf/simulated/floor/tiled/techmaint,
/area/abandoned_bunker/bunker/storage)
"v" = (
/obj/structure/table/rack,
/obj/item/stack/material/uranium/ten,
/obj/item/stack/material/uranium/ten,
/turf/simulated/floor/tiled/techmaint,
/area/abandoned_bunker/bunker/storage)
"w" = (
/obj/machinery/door/airlock/engineering{
	name = "Main Storage"
	},
/obj/structure/cable/cyan{
	icon_state = "4-8"
	},
/turf/simulated/floor/tiled/steel_grid,
/area/abandoned_bunker/bunker/storage)
"E" = (
/obj/structure/table/rack,
/obj/item/stack/material/glass/fifty,
/obj/item/stack/material/glass/fifty,
/obj/item/stack/material/glass/fifty,
/turf/simulated/floor/tiled/techmaint,
/area/abandoned_bunker/bunker/storage)
"H" = (
/obj/structure/table/rack,
/obj/structure/cable/cyan{
	icon_state = "4-8"
	},
/obj/item/stack/material/gold/ten,
/turf/simulated/floor/tiled/techmaint,
/area/abandoned_bunker/bunker/storage)
"I" = (
/obj/structure/table/rack,
/obj/item/stack/material/steel/fifty,
/obj/item/stack/material/steel/fifty,
/obj/item/stack/material/steel/fifty,
/turf/simulated/floor/tiled/techmaint,
/area/abandoned_bunker/bunker/storage)
"K" = (
/obj/structure/table/rack,
/obj/structure/cable/cyan{
	icon_state = "4-8"
	},
/obj/item/stack/material/silver/ten,
/turf/simulated/floor/tiled/techmaint,
/area/abandoned_bunker/bunker/storage)
"M" = (
/obj/structure/table/rack,
/obj/structure/cable/cyan{
	icon_state = "4-8"
	},
/obj/item/stack/material/plasteel/fifty,
/turf/simulated/floor/tiled/techmaint,
/area/abandoned_bunker/bunker/storage)
"N" = (
/obj/structure/table/rack,
/obj/structure/cable/cyan{
	icon_state = "4-8"
	},
/obj/item/stack/material/iron{
	amount = 50
	},
/turf/simulated/floor/tiled/techmaint,
/area/abandoned_bunker/bunker/storage)
"O" = (
/obj/machinery/light{
	dir = 1
	},
/turf/simulated/floor/tiled/steel_grid,
/area/abandoned_bunker/bunker/storage)
"W" = (
/obj/machinery/artifact,
/turf/simulated/floor/tiled/techmaint,
/area/abandoned_bunker/bunker/storage)
"X" = (
/obj/structure/table/rack,
/obj/random/junk,
/turf/simulated/floor/tiled/techmaint,
/area/abandoned_bunker/bunker/storage)

(1,1,1) = {"
a
a
a
a
w
a
a
a
a
"}
(2,1,1) = {"
a
s
s
s
c
s
s
s
a
"}
(3,1,1) = {"
a
s
r
u
H
u
v
s
a
"}
(4,1,1) = {"
a
s
o
u
N
u
u
s
a
"}
(5,1,1) = {"
a
O
E
u
K
u
W
e
a
"}
(6,1,1) = {"
a
s
d
u
g
u
u
s
a
"}
(7,1,1) = {"
a
s
I
u
M
u
X
s
a
"}
(8,1,1) = {"
a
s
s
s
k
s
s
s
a
"}
(9,1,1) = {"
a
a
a
a
a
a
a
a
a
"}
