//MAP CONVERTED BY dmm2tgm.py THIS HEADER COMMENT PREVENTS RECONVERSION, DO NOT REMOVE
"a" = (
/turf/template_noop,
/area/template_noop)
"c" = (
/obj/machinery/door/airlock/security,
/turf/simulated/floor/wood/walnut,
/area/template_noop)
"e" = (
/obj/random/shoes,
/obj/random/hat,
/obj/random/gloves,
/obj/random/glasses,
/obj/random/clothing,
/obj/structure/closet/wardrobe,
/obj/random/projectile,
/turf/simulated/floor/wood/walnut,
/area/template_noop)
"f" = (
/obj/structure/table/woodentable,
/obj/structure/flora/pottedplant/smallcactus{
	pixel_y = 11
	},
/turf/simulated/floor/wood/walnut,
/area/template_noop)
"s" = (
/obj/structure/filingcabinet/chestdrawer,
/turf/simulated/floor/wood/walnut,
/area/template_noop)
"t" = (
/obj/structure/bed/chair/office/light{
	dir = 1
	},
/turf/simulated/floor/wood/walnut,
/area/template_noop)
"C" = (
/obj/structure/bed/padded,
/turf/simulated/floor/wood/walnut,
/area/template_noop)
"I" = (
/obj/machinery/light/small{
	dir = 8
	},
/turf/simulated/floor/wood/walnut,
/area/template_noop)
"L" = (
/obj/structure/table/woodentable,
/obj/item/card/id/bunker/security/warden,
/turf/simulated/floor/wood/walnut,
/area/template_noop)
"Q" = (
/obj/structure/table/woodentable,
/obj/item/storage/mre/random{
	pixel_x = -12
	},
/obj/random/single/cola,
/turf/simulated/floor/wood/walnut,
/area/template_noop)
"Y" = (
/turf/simulated/floor/wood/walnut,
/area/template_noop)

(1,1,1) = {"
a
a
a
a
a
a
"}
(2,1,1) = {"
a
L
t
I
f
a
"}
(3,1,1) = {"
a
Q
Y
Y
Y
c
"}
(4,1,1) = {"
a
C
Y
e
s
a
"}
(5,1,1) = {"
a
a
a
a
a
a
"}
