//MAP CONVERTED BY dmm2tgm.py THIS HEADER COMMENT PREVENTS RECONVERSION, DO NOT REMOVE
"a" = (
/turf/template_noop,
/area/template_noop)
"b" = (
/obj/effect/floor_decal/corner/yellow/border,
/turf/simulated/floor/tiled,
/area/template_noop)
"c" = (
/turf/simulated/wall/r_titanium,
/area/template_noop)
"d" = (
/obj/effect/floor_decal/corner/yellow/border{
	dir = 1
	},
/obj/structure/table/steel,
/turf/simulated/floor/tiled,
/area/template_noop)
"f" = (
/obj/structure/cable/cyan{
	icon_state = "1-2"
	},
/turf/simulated/floor/tiled,
/area/template_noop)
"g" = (
/obj/structure/window/reinforced{
	dir = 1
	},
/turf/simulated/floor/tiled,
/area/template_noop)
"h" = (
/obj/effect/floor_decal/corner/yellow/border{
	dir = 5
	},
/obj/structure/closet/radiation,
/turf/simulated/floor/tiled,
/area/template_noop)
"i" = (
/obj/effect/floor_decal/corner/yellow/border{
	dir = 1
	},
/obj/machinery/light{
	dir = 1
	},
/turf/simulated/floor/tiled,
/area/template_noop)
"j" = (
/obj/structure/cable/cyan{
	icon_state = "1-2"
	},
/obj/structure/cable/cyan{
	icon_state = "1-8"
	},
/turf/simulated/floor/tiled,
/area/template_noop)
"k" = (
/obj/effect/floor_decal/corner/yellow/border{
	dir = 4
	},
/obj/structure/closet/radiation,
/turf/simulated/floor/tiled,
/area/template_noop)
"l" = (
/turf/simulated/floor/tiled,
/area/template_noop)
"m" = (
/obj/effect/floor_decal/corner/yellow/border{
	dir = 1
	},
/turf/simulated/floor/tiled,
/area/template_noop)
"n" = (
/obj/effect/floor_decal/corner/yellow/border{
	dir = 8
	},
/obj/structure/window/reinforced{
	dir = 1
	},
/turf/simulated/floor/tiled,
/area/template_noop)
"o" = (
/obj/effect/floor_decal/corner/yellow/border{
	dir = 4
	},
/obj/structure/window/reinforced{
	dir = 1
	},
/turf/simulated/floor/tiled,
/area/template_noop)
"t" = (
/obj/effect/floor_decal/corner/yellow/border{
	dir = 1
	},
/obj/machinery/power/apc{
	dir = 1;
	pixel_y = 24
	},
/obj/machinery/power/terminal{
	dir = 1
	},
/obj/structure/cable/cyan{
	icon_state = "0-2"
	},
/turf/simulated/floor/tiled,
/area/template_noop)
"u" = (
/obj/effect/floor_decal/corner/yellow/border{
	dir = 8
	},
/obj/machinery/light{
	dir = 8
	},
/turf/simulated/floor/tiled,
/area/template_noop)
"v" = (
/obj/effect/floor_decal/corner/yellow/border,
/obj/structure/table/steel,
/obj/item/stack/material/uranium/ten,
/obj/machinery/power/terminal{
	dir = 4
	},
/obj/structure/cable/cyan{
	icon_state = "0-8"
	},
/turf/simulated/floor/tiled,
/area/template_noop)
"w" = (
/obj/effect/floor_decal/corner/yellow/border{
	dir = 8
	},
/turf/simulated/floor/tiled,
/area/template_noop)
"x" = (
/obj/effect/floor_decal/corner/yellow/border{
	dir = 6
	},
/obj/machinery/power/port_gen/pacman/super/potato/reactor,
/obj/structure/cable/cyan{
	icon_state = "0-8"
	},
/turf/simulated/floor/tiled,
/area/template_noop)
"A" = (
/obj/effect/floor_decal/corner/yellow/border{
	dir = 4
	},
/turf/simulated/floor/tiled,
/area/template_noop)
"D" = (
/obj/effect/floor_decal/corner/yellow/border{
	dir = 10
	},
/turf/simulated/floor/tiled,
/area/template_noop)
"E" = (
/obj/structure/cable/cyan{
	icon_state = "2-4"
	},
/turf/simulated/floor/tiled,
/area/template_noop)
"F" = (
/obj/machinery/door/airlock/engineering{
	name = "Engineering Department"
	},
/obj/structure/cable/cyan{
	icon_state = "4-8"
	},
/turf/simulated/floor/tiled,
/area/template_noop)
"J" = (
/obj/effect/floor_decal/corner/yellow/border,
/obj/machinery/light,
/obj/structure/table/steel,
/obj/item/stack/material/uranium/ten,
/obj/machinery/power/terminal{
	dir = 8
	},
/obj/structure/cable/cyan{
	icon_state = "0-4"
	},
/turf/simulated/floor/tiled,
/area/template_noop)
"K" = (
/obj/effect/floor_decal/corner/yellow/border{
	dir = 8
	},
/obj/structure/cable/cyan{
	icon_state = "4-8"
	},
/turf/simulated/floor/tiled,
/area/template_noop)
"L" = (
/obj/structure/cable/cyan{
	icon_state = "1-8"
	},
/obj/structure/cable/cyan{
	icon_state = "2-8"
	},
/turf/simulated/floor/tiled,
/area/template_noop)
"M" = (
/obj/effect/floor_decal/corner/yellow/border,
/obj/machinery/power/smes/buildable,
/obj/structure/cable/cyan,
/turf/simulated/floor/tiled,
/area/template_noop)
"N" = (
/obj/machinery/door/window/brigdoor/northleft,
/turf/simulated/floor/tiled,
/area/template_noop)
"P" = (
/obj/effect/floor_decal/corner/yellow/border{
	dir = 9
	},
/obj/structure/table/steel,
/turf/simulated/floor/tiled,
/area/template_noop)
"Q" = (
/obj/structure/cable/cyan{
	icon_state = "4-8"
	},
/turf/simulated/floor/tiled,
/area/template_noop)
"S" = (
/obj/effect/floor_decal/corner/yellow/border{
	dir = 4
	},
/obj/machinery/light{
	dir = 4
	},
/obj/structure/closet/radiation,
/turf/simulated/floor/tiled,
/area/template_noop)
"U" = (
/obj/effect/floor_decal/corner/yellow/border{
	dir = 10
	},
/obj/machinery/power/port_gen/pacman/super/potato/reactor,
/obj/structure/cable/cyan{
	icon_state = "0-4"
	},
/turf/simulated/floor/tiled,
/area/template_noop)
"V" = (
/obj/machinery/door/window/brigdoor/northright,
/obj/structure/cable/cyan{
	icon_state = "1-2"
	},
/turf/simulated/floor/tiled,
/area/template_noop)
"Z" = (
/obj/effect/floor_decal/corner/yellow/bordercorner{
	dir = 8
	},
/turf/simulated/floor/tiled,
/area/template_noop)

(1,1,1) = {"
c
c
F
c
c
a
a
a
a
a
"}
(2,1,1) = {"
c
P
K
D
c
a
a
a
a
a
"}
(3,1,1) = {"
c
d
Q
b
c
a
a
a
a
a
"}
(4,1,1) = {"
c
d
Q
b
c
a
a
a
a
a
"}
(5,1,1) = {"
c
i
Q
b
c
a
a
a
a
a
"}
(6,1,1) = {"
c
m
Q
b
c
a
a
a
a
a
"}
(7,1,1) = {"
c
m
Q
b
c
a
a
a
a
a
"}
(8,1,1) = {"
c
m
Q
b
c
a
a
a
a
a
"}
(9,1,1) = {"
c
m
Q
b
c
c
c
c
c
c
"}
(10,1,1) = {"
c
m
Q
Z
n
w
u
w
U
c
"}
(11,1,1) = {"
c
i
Q
l
g
l
l
l
v
c
"}
(12,1,1) = {"
c
m
Q
l
N
l
l
E
M
c
"}
(13,1,1) = {"
c
t
L
f
V
f
f
j
M
c
"}
(14,1,1) = {"
c
m
l
l
g
l
l
l
J
c
"}
(15,1,1) = {"
c
h
k
S
o
A
A
A
x
c
"}
(16,1,1) = {"
c
c
c
c
c
c
c
c
c
c
"}
