//MAP CONVERTED BY dmm2tgm.py THIS HEADER COMMENT PREVENTS RECONVERSION, DO NOT REMOVE
"a" = (
/turf/template_noop,
/area/template_noop)
"g" = (
/obj/structure/bed/chair/wood,
/turf/simulated/floor/wood/maple,
/area/template_noop)
"k" = (
/obj/random/mre/dessert/vegan,
/turf/simulated/floor/wood/maple,
/area/template_noop)
"l" = (
/obj/effect/decal/cleanable/dirt,
/turf/simulated/floor/wood/maple,
/area/template_noop)
"m" = (
/obj/structure/bed/chair/wood,
/obj/effect/decal/cleanable/filth,
/turf/simulated/floor/wood/maple,
/area/template_noop)
"n" = (
/obj/machinery/door/airlock/glass/security,
/turf/simulated/floor/wood/maple,
/area/template_noop)
"o" = (
/obj/random/mre/dessert,
/obj/effect/decal/cleanable/dirt,
/obj/machinery/light{
	dir = 8
	},
/turf/simulated/floor/wood/maple,
/area/template_noop)
"t" = (
/obj/structure/table/woodentable,
/obj/item/reagent_containers/food/snacks/canned/beef{
	pixel_x = -4;
	pixel_y = 5
	},
/turf/simulated/floor/wood/maple,
/area/template_noop)
"u" = (
/obj/structure/table/woodentable,
/obj/item/reagent_containers/food/snacks/canned/caviar{
	pixel_y = -3
	},
/obj/item/reagent_containers/food/snacks/canned/caviar/true{
	pixel_y = 4
	},
/obj/item/reagent_containers/food/snacks/canned/caviar{
	pixel_x = 2;
	pixel_y = 11
	},
/obj/item/reagent_containers/food/snacks/canned/caviar/true{
	pixel_y = 18
	},
/obj/item/reagent_containers/food/snacks/canned/caviar{
	pixel_x = 4;
	pixel_y = 25
	},
/obj/item/reagent_containers/food/snacks/cheesyfries{
	pixel_x = -16;
	pixel_y = -6
	},
/turf/simulated/floor/wood/maple,
/area/template_noop)
"w" = (
/obj/structure/table/woodentable,
/obj/item/reagent_containers/food/snacks/canned/beef{
	pixel_y = -3
	},
/obj/item/reagent_containers/food/snacks/canned/beans{
	pixel_x = 13;
	pixel_y = 5
	},
/obj/effect/decal/cleanable/dirt,
/turf/simulated/floor/wood/maple,
/area/template_noop)
"x" = (
/obj/machinery/vending/soda,
/obj/effect/decal/cleanable/dirt,
/turf/simulated/floor/wood/maple,
/area/template_noop)
"D" = (
/obj/structure/table/woodentable,
/obj/item/reagent_containers/food/snacks/canned/beans{
	pixel_y = 5
	},
/obj/item/reagent_containers/food/snacks/canned/spinach{
	pixel_x = -12;
	pixel_y = 6
	},
/obj/item/reagent_containers/food/snacks/grilledcheese{
	pixel_x = -10;
	pixel_y = -7
	},
/turf/simulated/floor/wood/maple,
/area/template_noop)
"H" = (
/obj/structure/table/woodentable,
/obj/item/material/kitchen/utensil/fork{
	pixel_x = 10
	},
/obj/item/reagent_containers/food/snacks/cheeseburger,
/obj/item/reagent_containers/food/snacks/hotdog{
	pixel_x = 5;
	pixel_y = 16
	},
/obj/effect/decal/cleanable/dirt,
/turf/simulated/floor/wood/maple,
/area/template_noop)
"I" = (
/obj/structure/table/woodentable,
/obj/item/reagent_containers/food/snacks/fishandchips,
/obj/item/reagent_containers/food/snacks/fishfingers{
	pixel_x = -12;
	pixel_y = -5
	},
/obj/machinery/light{
	dir = 4
	},
/turf/simulated/floor/wood/maple,
/area/template_noop)
"J" = (
/turf/simulated/floor/wood/maple,
/area/template_noop)
"K" = (
/obj/machinery/vending/sovietsoda,
/turf/simulated/floor/wood/maple,
/area/template_noop)
"M" = (
/obj/structure/table/woodentable,
/obj/random/mre,
/obj/random/mre,
/obj/random/mre,
/obj/random/mre,
/turf/simulated/floor/wood/maple,
/area/template_noop)
"N" = (
/obj/structure/table/woodentable,
/obj/item/reagent_containers/food/snacks/sandwich{
	pixel_x = 4;
	pixel_y = 11
	},
/obj/item/reagent_containers/food/snacks/semki{
	pixel_x = -13
	},
/turf/simulated/floor/wood/maple,
/area/template_noop)
"P" = (
/obj/machinery/vending/snack,
/obj/effect/decal/cleanable/dirt,
/turf/simulated/floor/wood/maple,
/area/template_noop)
"Q" = (
/obj/structure/bed/chair/wood{
	dir = 1
	},
/obj/effect/decal/cleanable/filth,
/turf/simulated/floor/wood/maple,
/area/template_noop)
"S" = (
/obj/effect/decal/cleanable/filth,
/turf/simulated/floor/wood/maple,
/area/template_noop)
"T" = (
/obj/structure/bed/chair/wood{
	dir = 1
	},
/turf/simulated/floor/wood/maple,
/area/template_noop)
"U" = (
/obj/structure/bed/chair/wood{
	dir = 1
	},
/obj/effect/decal/cleanable/dirt,
/turf/simulated/floor/wood/maple,
/area/template_noop)
"W" = (
/obj/structure/bed/chair/wood,
/obj/effect/decal/cleanable/dirt,
/turf/simulated/floor/wood/maple,
/area/template_noop)
"Y" = (
/obj/random/mre/dessert,
/obj/effect/decal/cleanable/dirt,
/turf/simulated/floor/wood/maple,
/area/template_noop)

(1,1,1) = {"
a
a
a
a
a
a
"}
(2,1,1) = {"
a
M
U
o
P
a
"}
(3,1,1) = {"
a
N
T
J
x
a
"}
(4,1,1) = {"
a
l
l
S
K
a
"}
(5,1,1) = {"
n
Y
l
l
k
a
"}
(6,1,1) = {"
a
m
w
H
U
a
"}
(7,1,1) = {"
a
g
t
u
U
a
"}
(8,1,1) = {"
a
W
D
I
Q
a
"}
(9,1,1) = {"
a
a
a
a
a
a
"}
